%s ago= %s în urmă
%s used of %s %s %%=%s folosit de %s (%s %%)
10 s= 10 s
30 s= 30 s
1 m= 1 m
2 m= 2 m
Active tunnels= Tuneluri active
Activity= Activitate
ago= în urmă
Airflow= Flux de aer
All Apps= Toate aplicațiile
All VMs= Toate VM
Battery charge= Încărcare baterie
BIOS dated= BIOS datat
Click to toggle CPU chart= Faceți clic pentru a vedea diagrama CPU
Click to toggle details= Faceți clic pentru mai multe detalii
Completed= Completat
Counters info= Informații contoare
Current operation %s on %s= Funcționare acum %s din **%s**
custom image= imagine personalizată
Data is invalid= Data este invalidă
default image= imagine standard
Docker Containers= Containere „Docker”
Due in=
Elapsed time= Timp scurs
Errors info= Informații erori
Estimated finish= Terminare aproximativă
failed device= dispozitiv defect
Fan count= număr ventilator
FAN= ventilator
Finding %s error=Găsit: **%s** eroare
Finding %s errors=Găsit: **%s** erori
General info= Informații generale
Go to CPU pinning settings= Accesați setătri fixe CPU
Go to disk settings= Accesați setări discuri
Go to Docker settings= Accesați setări Docker
Go to fan settings= Accesați setări ventilatoare
Go to identification settings= Accesați setări idendificare
Go to network settings= Accesați setări rețea
Go to scheduler settings= Accesați setări programare
Go to Share settings= Accesați setări Partajare
Go to UPS settings= Accesați setări UPS
Go to User settings= Accesați setări Utilizator
Go to VM settings= Accesați setări VM
Go to VPN settings= Accesați setări VPN
Handshake= Handshake
has= are
healthy= în stare bună
heat warning= atenționare temperatură
Hide details= Ascunde detaliile
in progress= îm progres
Inactive tunnels= Tuneluri inactive
inactive= inactiv
Inbound= Intrare
invalid device= dispozitiv nevalid
invalid devices= dispozitive nevalide
Last check completed on %s= Ultima verificare completată la **%s**
Last check incomplete on %s= Ultima verificare incompletă la **%s**
Last checked on %s= Ultima verificare la **%s**
Maximum size= Mărime maximă
Mode of operation= Mod de operare 
Network traffic= Trafic rețea
Next check scheduled on %s=Următoarea verificare programată la **%s**
No docker containers defined= Niciun container Docker definit
No running docker containers= Nu rulează niciun container Docker
No running virtual machines= Nu rulează nicio VM
No shares present= Nicio partajare activă
No virtual machines defined= Nicio mașină virtuală definită
Nominal power= Putere nominală
not received= neprimit
Only PNG images are allowed=Doar imaginile PNG sunt acceptate!
Outbound= Ieșire
Output voltage= Voltaj ieșire
Overall Load= Încărcare per total
Parity disk not present= Disc de paritate neprezent
Parity disks not present= Discuri de paritate neprezente
Parity has not been checked yet= Paritatea încă nu a fost verificată
Parity is degraded= Paritatea este degradată
Power= Putere
Put system to sleep= Pune sistemul în modul „sleep”
Reboot the system= Rebootează sistemul
Receive counters= Contoare primiri
Received packets= Pachete primite
Runtime left= Timp de rulare rămas
Scheduled parity check is disabled= Verificarea programată a parității este dezactivată
Select Case Model= Selectează Case Model
Select time frame= Selectează intervalul de timp
Share count %s with %s cache only and %s encrypted= Număr partajări: %s cu %s doar cache și %s criptat
Show details= Arată detalii
Show Information= Arată Informații
Shutdown the system= Oprește sistemul
SMART error= eroare SMART
SMART health-check failed= Verificare stare SMART eșuată
SMART= SMART
sn=s/n
Start the array= Pornește array-ul
Started only= Pornit doar
Stop the array= Oprește array-ul
Temp= Temp
This will put the system to sleep= Acest lucru va pune sistemul în stare **somn**
This will reboot the system= Acest lucru va duce la **repornirea** sistemului
This will shutdown the system= Acest lucru va duce la **oprirea** sistemului
This will start the array= Acest lucru va **porni array-ul**
This will stop the array= Acest lucru va **opri array-ul**
Transmit counters= Transmite contoare
Transmitted packets= Pachete transmise
UPS Load= Solicitare UPS
UPS status= Status UPS
Usable size= Spațiu utilizabil
User count %s with %s unprotected=Număr utilizatorit: %s cu %s nesecurizat
utilization warning= atenționare utilizare
View Running Processes= Vezi Procesele ce rulează
Virtual Machines= Mașini Virtuale
