20 EHCI = 2.0 (EHCI)
30 nec XHCI = 3.0 (nec XHCI)
30 qemu XHCI = 3.0 (qemu XHCI)
Allocation= Alocare
and if using graphics device passthrough it too needs UEFI=și dacă folosirea dispozitivului grafic trece prin ea are nevoie și de UEFI
Are you sure=Sunteți sigur
ew Virtual Machines=Array-ul trebuie să fie **pornit** pentru a vizualiza mașini virtuale
Autostart=Autostart
Back=Înapoi
Bus=Bus
Capacity=Capacitate
Change Icon=Schimbă Pictograna
Cleanup=Curățire
Click and Select cdrom image to install operating system= Faceți clic și selectați imaginea cdrom pentru a instala sistemul de operare
Config Folder= Dosar Config
Copy Paste Domain XML Configuration Here=Copierea și lipirea configurației XML a domeniului aici
CPU Mode= Modul CPU
CPUs= Procesoare
Create=Creează
Creating=Se creează
define the amount memory=definește cantitatea de memorie
define the maximum amount of memory=definește cantitatea maximă de memorie
define type of cpu presented to this vm=definiți tipul de CPU prezentat acestei VM
description of virtual machine=descrierea mașinii virtuale
Disk devices=dispozitive disc
Download Folder=Dosar Descărcare
Download, Click and Select virtio drivers image=Descărcați, Clicați și Selectați imaginea driverelor virtio
Downloading=Se descarcă
eg=e.g.
Emulated=Emulat
ETA=ETA
Extracting=Se extrage
Folder to save the LibreELEC image to=Dosarul unde să se salveze imaginea LibreELEC
Folder to save the OpenELEC image to=Dosarul unde să se salveze imaginea OpenELEC
Form View=Vizualizare Formular
free=liber
Graphics Card=Placă Grafică
Graphics ROM BIOS=ROM BIOS al Plăcii Grafice
Graphics=Grafică
Guest not running or guest agent not installed=Guest nu rulează sau agentul guest nu este instalat
Host Passthrough=Trecere Host
Hyperv tweaks for Windows=Ajustări Hyper-v pentru Windows
Hyper-V=Hyper-v
i440fx will work for most=i440fx va funcționa pentru majoritatea
Icon=Pictogramă
Initial=Inițial
Interfaces=Interfețe
Invalid storage path=Cale stocare invalidă
Invalid VM to edit=VM invalid pentru editare
IP Address=Adresă IP
ISO storage path doesnt exist=Calea de stocare ISO nu există
ISO storage path doesnt exist, please create the user share or empty folder first=Calea de stocare ISO nu există, creați mai întâi partajarea utilizatorului (sau folderul gol).
ISO storage path was empty=Calea de stocare ISO era goală
keyboard for VNC=tastatură pentru VNC
LibreELEC Version=Versiune LibreELEC
LibreELEC=LibreELEC
Libvirt Service failed to start=pornirea Serciviul Libvirt a eșuat
Logical CPUs=CPU-uri Logice
Machine=Mașină
Manual=Manual
Max=Max
MD5 verification failed, your download is incomplete or corrupted=Verificarea MD5 a eșuat, descărcarea este incompletă sau coruptă
mount tag inside vm=montează eticheta în interiorul mașinii virtuale
My Workstation=Stația de de lucru
name of mount tag inside vm=numele etichetei în interiorul mașinii virtuale
Name of virtual machine=Numele mașinii virtuale
Network Bridge=Bridge Rețea
Network MAC=MAC Rețea
Network Model=Model Rețea
No Virtual Machines installed=Nicio Mașină Virtuală instalată
None available=Niciunul/a disponibil/ă
Not enough free space, need at least=Nu există suficient spațiu liber, este necesar cel puțin
Not running=Nu în funcțiune
OpenELEC Version=Versiune OpenELEC
OpenELEC=OpenELEC
OS Install CDRom Bus=Instalează driverul pentru busul CDRom în sistemul de operare
OS Install ISO=ISO Instalare SO
Other PCI Devices=Alte dispozitive PCI
OVMF requires a UEFI-compatable OS=OVMF necesită un SO UEFI-compatable
OVMF=OVMF
OVMF TPM=OVMF TPM
password for VNC=parolă pentru VNC
path of Unraid share=calea partajării Unraid
Path on Unraid share to save LibreELEC settings = Cale pe partajarea Unraid pentru a salva setările LibreELEC
Path on Unraid share to save OpenELEC settings = Cale pe partajarea Unraid pentru a salva setările OpenELEC
Path to ROM BIOS file = Cale către fișierul BIOS ROM
Please choose a folder the LibreELEC image will download to = Alegeți un folder în care imaginea LibreELEC va fi descărcată
Please choose a folder the OpenELEC image will download to = Alegeți un folder în care imaginea OpenELEC va fi descărcată
Pop-up Blocker is enabled Please add this site to your exception list= Pop-up Blocker is enabled! Please add this site to your exception list
Prefix = Prefix
Primary = Principal
Q35 for a newer machine model with PCIE = Q35 pentru un model de mașină mai nou cu PCIE
QEMU64 = QEMU64
Random mac, you can supply your own = MAC aleator, poți furniza unul propriu
Re-generate random mac address = Regenerare adresă MAC aleatorie
Remove LibreELEC image = Șterge imaginea LibreELEC
Remove OpenELEC image = Șterge imaginea OpenELEC
Remove this LibreELEC file = Șterge acest fișier LibreELEC
Remove this OpenELEC file = Șterge acest fișier OpenELEC
SeaBIOS will work for most = SeaBIOS va funcționa pentru majoritatea
SeaBIOS = SeaBIOS
Select the BIOS = Selectează BIOS-ul
Select the LibreELEC version to use = Selectează versiunea LibreELEC de folosit
Select the machine model = Selectează modelul mașinii
Select the OpenELEC version to use = Selectează versiunea OpenELEC de folosit
Select the USB Controller to emulate = Selectează controllerul USB de emulat
Separate sub-folder and image will be created based on Name = Se va crea un subdirector separat și o imagine pe baza numelui
Shares = Acțiuni (sau Partajări)
Some OSes wont support USB3 = Some OSes won't support USB3
Sound Card = Placă de sunet 
Specify a ISO storage path first = Specificați mai întâi o cale de stocare pentru ISO
Start All = Pornește toate 
Start VM after creation = Pornește VM după creare 
Stop All = Oprește toate
Toggle VM autostart = Comută pornirea automată a VM
type of storage image = tipul imaginii de stocare
Unknown action = Acțiune necunoscută
Unknown version = Versiune necunoscută 
Unraid Mount tag = Etichetă de montare Unraid
Unraid Share=Partajare Unraid
Updating=Se actualizează
USB Controller=Controler USB
USB Devices=Dispozitive USB
vDisk Bus=Bus vDisc
vDisk Location=Locație vDisc
vDisk Size=Mărime vDisc
vDisk Type=Tip vDisc
vDisks=vDiscuri
Verifying=Se verifică
video for VNC=video pentru VNC
VirtIO Drivers CDRom Bus=Drivere CDRom Bus VirtIO
VirtIO Drivers ISO=Drivere ISO VirtIO
Virtual Machines=Mașini Virtuale
VM creation error=Eroare la creearea VM
VM image deletion error=Eroare în ștergerea imaginii VM
VNC Keyboard = Tastatură VNC
VNC Password = Parolă VNC
VNC Video Driver = Driver Video VNC
VNC = VNC
Wasnt able to stop the process = Nu a fost capabil să oprească procesul
Windows 7XP = Windows 7/XP
Windows 82012, newer Linux distros = Windows 8/2012, noile distribuții de Linux
XML View = Vizualizare XML
